Concepto,Fecha (DD/MM/AA),Referencia,Cargo,Abono,Saldo,Cuenta,Código,No. Secuencia
RASTREO 8846APR2202411283572402971 REFERENCIA:22996 HORA:08:56:12 SPEI RECIBIDO DE 72-BANORTE DE SG PROVEEDORES SA DE CV DE LA CTA CLABE 072580001320209494 RFC SGP880517EJ7 CONCEPTO A12102,28/11/2024,22996,0,269746.4,3231080.26,11101009582,AS,1
RASTREO BNET01002411280028957897 REFERENCIA:281124 HORA:09:31:28 SPEI RECIBIDO DE 12-BBVA MEXICO DE SILVER FLAME SA DE C V DE LA CTA CLABE 012580001202420474 RFC SFL220629R20 CONCEPTO PAGO,28/11/2024,281124,0,19516.46,3250596.72,11101009582,AS,2
RASTREO 241128094015501944277231645874 REFERENCIA:281124 HORA:09:40:19 SPEI ENVIADO A 12-BBVA MEXICO A SEGURITEC (DATO NO VERIFICADO POR ESTA INSTITUCION) A LA CTA CLABE 012180001905052264 RFC ND CONCEPTO GRAVMARK,28/11/2024,281124,490255,0,2760341.72,11101009582,CS,3
RASTREO 241128094017501944281231645882 REFERENCIA:281124 HORA:09:40:19 SPEI ENVIADO A 12-BBVA MEXICO A SEGURITEC (DATO NO VERIFICADO POR ESTA INSTITUCION) A LA CTA CLABE 012180001905052264 RFC ND CONCEPTO GRAVMARK,28/11/2024,281124,472482,0,2287859.72,11101009582,CS,4
RASTREO 241128094850501945815231647638 REFERENCIA:281124 HORA:09:48:53 SPEI ENVIADO A 653-KUSPIT A SEPSA MONTERREY KUSPIT (DATO NO VERIFICADO POR ESTA INSTITUCION) A LA CTA CLABE 653180003810201619 RFC ND CONCEPTO OPERACION E INTERMEDIACION DE FONDOS,28/11/2024,281124,502398,0,1785461.72,11101009582,CS,5
RASTREO 241128094851501945823231647641 REFERENCIA:281124 HORA:09:48:57 SPEI ENVIADO A 653-KUSPIT A SEPSA MONTERREY KUSPIT (DATO NO VERIFICADO POR ESTA INSTITUCION) A LA CTA CLABE 653180003810201619 RFC ND CONCEPTO OPERACION E INTERMEDIACION DE FONDOS,28/11/2024,281124,561367,0,1224094.72,11101009582,CS,6
RASTREO HSBC257506 REFERENCIA:241128 HORA:09:55:57 SPEI RECIBIDO DE 21-HSBC DE SAUL VICENTE  ZUÑIGA ALVAREZ DE LA CTA CLABE 021580040425595837 RFC ZUAS710903BB9 CONCEPTO SERVICIO DE CAPACITACION A SAUL ZUNIGA,28/11/2024,241128,0,30068.48,1254163.2,11101009582,AS,7
RASTREO BNET01002411280028974541 REFERENCIA:281124 HORA:10:18:32 SPEI RECIBIDO DE 12-BBVA MEXICO DE FUD TRAILERS MARTINE Z SA DE CV DE LA CTA CLABE 012580001142628161 RFC FTM1911128T6 CONCEPTO EFECTIVO DESPACHO,28/11/2024,281124,0,71283.9,1325447.1,11101009582,AS,8
